WWWWWWWWWW
W b  VS  W
W  HHV   W
W   YVF FW
W        W
WWWWWWWWWW
W A  B   W
W   R WWWW
W   R X NW
WWWWWWWWWW