WWWWWWWWWW
W        W
W  HHHY  W
W   B  R W
W    WWWWW
W S  W
W A  W b W
W    WWXWW
W   s    W
WWWWWWWWWW