WWWWWWWWWW
WAA     CW
W   HHHH W
W    bB  W
W  S WXXXW
W    W
W   WW   W
W    W   W
W   C  T W
WWWWWWWWWW